XI...IXX..
X...XXXXXI
XXXXXXXX..
..XX..XXX.
I..XXXX.XX
XXXXI...XO