.I..XXX..XXXI..
XXXXX.XXXXX.X..
.X..XXXX....X..
XXX.X..X.OXXX..
X.I...XI..XX...