IXX....XXXXXX
.XXXXXXX...XX
OX..XXXXXXXXI
...I..X..X...
IXXX.XX.XXXXX
X.XX.XX.XX..X
X.XXXXXXXI.XX
XXXX......XXI